Gabriel	epicpew.ca	Gabriel	Katharina
wanting	wanma.ca	wanting	maedeh
Octavio Abel	dhcplovers.ca	Octavio Abel	Cuneyt
aidan	PG13.ca	aidan	dany
Robert	ProjectBlank.ca	Robert	qiuning
Shirley	mlpsm.ca	Shirley	Mathieu
nolan	vin8.ca	nolan	vinuyan
Raagav	forkbomb.ca	Raagav	Santiago
Mady	mid.ca	Mady	Noah
wanting	wanma.ca	wanting	maedeh
maxime	responsiblewaiter.ca	maxime	bastian
christopher	CultOfFozzie.ca	christopher	vinh
michael	turnbite.ca	michael	christopher
Veronika	rocket.ca	Veronika	Maria
Michael	turnbite.ca	Michael	Chris
Aidan	PG13.ca	Aidan	Dany
johnny	muppetchurch.ca	johnny	domenico
Harout	onmeow.ca	Harout	Tomas, Danh
kyle	kna.ca	kyle	andrew
adam	linuxishard.ca	adam	raphael
